1111125555
1111123333
1123321111
1125521111
1123131111
1111111111
1111111111
1111111111
1111111111
1111111111